12 15
0 0 0 0 7 0 0 0 0 0 0 0
0 0 0 0 0 0 0 0 0 0 0 0
0 0 0 0 0 0 0 0 0 0 0 0
0 0 0 0 0 0 0 0 2 2 0 0
0 0 0 0 0 0 0 0 6 6 0 0
0 0 0 0 0 0 0 0 0 0 0 0
0 0 0 2 2 0 1 0 0 0 0 0
0 0 0 0 2 1 1 1 0 0 0 0
0 0 0 0 0 0 1 0 0 2 0 0
0 0 0 0 0 0 0 0 0 2 2 0
0 0 0 0 0 0 0 0 0 0 0 0
0 0 2 6 0 0 0 0 0 0 0 0
0 0 2 6 0 0 0 0 0 0 0 0
0 0 0 0 0 0 0 0 0 0 0 0
0 0 0 0 0 0 0 7 0 0 0 0
