10 11
0 0 0 8 0 0 0 0 0 0
0 0 0 0 0 0 0 0 0 0
0 0 0 0 0 0 0 0 0 0
0 0 0 2 2 0 0 0 0 8
0 0 0 0 2 0 0 0 0 0
0 0 0 0 6 0 0 0 0 0
8 0 0 0 6 18 3 4 5 0
0 0 0 0 1 0 0 0 0 0
0 0 0 0 0 0 0 0 0 0
0 0 0 0 0 0 0 0 0 0
0 0 0 0 0 8 0 0 0 0
