10 11
0 0 0 0 8 0 0 0 3 3
0 0 0 0 0 0 0 0 3 3
0 0 0 1 1 1 0 0 0 0
0 0 0 0 0 0 0 0 0 0
0 8 0 0 0 0 9 9 9 0
8 8 8 0 0 0 9 9 9 0
8 8 8 8 0 0 9 9 9 0
0 0 8 8 0 0 0 0 0 0
0 0 0 0 0 1 1 0 0 0
0 3 3 0 0 1 0 0 0 0
0 3 3 0 0 0 8 0 0 0
