10 11
0 0 0 0 0 0 0 0 0 0
0 0 0 0 0 0 0 0 0 0
0 0 0 0 0 9 9 9 9 0
0 0 0 2 2 9 9 9 9 0
0 0 0 2 2 2 2 9 9 0
0 0 0 2 2 2 2 9 0 0
0 0 0 0 0 2 2 9 0 0
0 0 0 0 7 0 0 2 0 0
0 0 7 7 7 7 0 2 2 0
0 0 0 0 7 0 0 0 2 0
0 0 0 0 0 0 0 0 2 2
